odcam=Orion Drift Camera
spankyui=SpankyUI
gp=GorillaPad
hp_left=(Dev)HoldablePad
gc=(Dev)GorillaCraft v{0}
gs=(Dev)GorillaShirts [VERY OLD]
shirtversion=(Dev)GorillaShrits v{0} [OLD]
gorillashirts=(Dev)GorillaShirts
infowatchversion=(Dev)GorillaInfoWatch v{0} [OLD]
infowatch=(Dev)GorillaInfoWatch
github.com/zlothy29iq/roomutils-iw=(Zlothy)RoomUtils [GorillaInfoWatch Addon]
github.com/zlothy29iq/zloth-recroomrig=(Zlothy)RecRoomRig v{0}
github.com/zlothy29iq/monkeclick=(Zlothy)MonkeClick v{0}
github.com/zlothy29iq/monkeclick-ci=(ZLothy)MonkeClick v{0} [ComputerInterface]
github.com/zlothy29iq/toomuchinfo=(Zlothy)TooMuchInfo v{0}
github.com/zlothy29iq/monkerealism=(Zlothy)MonkeRealism v{0}
github.com/zlothy29iq/gorillamediadisplay=(Zlothy)GorillaMediaDisplay
dingus=(Zlothy)Networked Maxwell
customskin=(Dev)Custom Skin
gpronouns=(Dev)Gorilla Pronouns
gfaces=(Dev)GorillaFaces
hasgface=GorillaFaces2?
monkephone=(Dev)MonkePhone
pmversion=(Dev)PlayerModel v{0}
gtrials=GorillaTrials
bp15's lobby gui=(BP15)bp15s lobby GUI
disconnect mod=(BP15)Disconnect Mod
gorillaplayeriddisplay=(BP15)GorillaPlayerIDDisplay
pcneckmovement=(BP15)PCNeckMovement
fusioned=DecalFree Fusioned
equippedweapon=Weapon Pack v{0}
grateversion=Grate v{0}
msp=MonkeSmartPhone
competitiveplusplus=Competitive++ v{0}
gorillawatch=GorillaWatch v{0}
gorillastats=GorillaStats
using gorilladrift=GorillaDrift
cheese is gouda=(Han)WhoIsCheating
whoisthatmonke version=(Han)WhoIsThatMonke v{0}
monkehavocversion=MonkeHavoc v{0}
carname=GorillaVehicles
tictactoe=TicTacToe
bananaos=BananaOS v{0}
panelopen=BananaOS Networker
ccolor=Index v{0}
imposter=Gorilla AmongUs
freakcam=CameraMod
hansolo1000falcon, stop reading my custom props=Ariel Camera
https://github.com/arielthemonke/gorillacraftautobuilder=GorillaCraft AutoBuilder
spectapeversion=Spectape v{0}
cats=Cats
cats updated=Cats Updated
made by biotest05 :3=Dogs
dogs=Dogs2?
dogs mod menu (this shit is legal, mkay?)=Dogs but horrible
fys cool magic mod=FYS Magic Mod
bananaphone=BananaPhone
colour=Custom Cosmetics
chainedtogether=Chained Together
shinygorilla=ShinyUtils
blueyyy=Blueyyy WASD
goofywalkversion=(Han)Goofy Walk
aweawe=RecRoomRig
body tracking=FullBody Tracking
body estimation=FullBody Estimation
simpleboardsversion=SimpleBoards v{0}
gorillanametags=(Han)GorillaNametags
nametagsplusplus=(Han)Nametags++ v{0}
fps-nametags for zlothy=(Han)FPS-Nametags for Zlothy
a mod that has to do with network stuff in grate (it won't work for most people)=(Han)Grate Admin Abuser
hamburbur=Hamburbur Menu
custom property setter=CustomPropertySetter
mediapad=Media Pad
gorillacinema=Gorilla Cinema
walksimulator=(Zlothy)WalkSimulator [Upheld by Zlothy]
deetags=DeeTags
kingbingus.oculusreportmenu=OculusReportMenu
isusingmeta=MetaReportMenu
chainedtogetheractive=Chained Together Active
graze heath system=Graze Health System
gorillashop=GorillaShop v{0}
gorillatorsoestimator=GorillaTorsoEstimator
gorilla track 2.2.0=Gorilla Track v2.2.0
gorilla track packed=Gorilla Track Packed
boy do i love information=Boy do I love information
pineappleterminal=Pineapple Terminal
cody likes burritos=ShutUpMonkeys
fallmonke_prop=FallMonke
gphysversion=GPhysics
lunar and oatmeal are sigma=(Cheat)METADATA CUSTOM OS
i like cheese=(Cheat)REC ROOM CHEAT
void=(Cheat)Void
void_menu_open=(Cheat)Void 2?
cronos=(Cheat)Cronos
violetpaiduser=(Cheat)Violet Paid
violetfreeuser=(Cheat)Violet Free
vivid=(Cheat)Vivd
orbit=(Cheat)Orbit
6p72ly3j85pau2g9mda6ib8px=(Cheat)CCMV2 [Colossus Cheat Menu v2]
obsidianmc=(Cheat)Obsidian.LOL
hidden menu=(Cheat)Hidden
oblivionuser=(Cheat)Oblivion
phantom=(Cheat)Phantom
\grnjiughurehhreuhghrebiuvbrheubfgudejhbgfuhdsguyh_jernbghjerhbhuj.rejugerufuweghguiye/rejughuywregfuyrewgfuygerwb\n\n\n\njghurfehgfuyeryheruihui_juhjg=gkrengjre\n=(Cheat)Resurgence
slientcc=(Cheat)SlientCC
renwo=(Cheat)Renwo
fysmenu=(Cheat)FYS Menu
evewatch=(Cheat)Eve Watch
blehuser=(Cheat)Bleh Menu
genesis=(Cheat)Genesis
asteroidlite=(Cheat)Asteroid Lite
modmenu=(Cheat)Tranzic
control=(Cheat)Control
controlfree=(Cheat)Control Free
flux=(Cheat)Flux
elux=(Cheat)Elux
serum=(Cheat)Serum
cokecosmetics=(Cheat)Horrible Cosmetx
mistuser=(Cheat)Mist
untitled=(Cheat)Untitled
silliness=(Cheat)Silliness
eyerock reborn=(Cheat)Eyerock Reborn
elysorpaid=(Cheat)Elysor Paid
evicteduser=(Cheat)Evicted
emotewheel=(Cheat)Emote Wheel v{0}
drowsiiiheadmodfications=Drowsiii Head Modifications
